q	げ
w	じ
e	ぇ
r	ぁ
t	さ
y	に
u	づ
i	ち
o	だ
p	つ
a	け
s	い
d	し
f	ぉ
g	ぞ
h	で
j	っ
k	た
l	び
z	せ
x	ぜ
c	ず
v	そ
b	ば
n	ぬ
m	ぱ
Q	こ
W	す
E	え
R	あ
T	ざ
O	ぢ
P	て